0  1  1  1  1  1  1  1  1  1  1  1  1  1  2
16 17 17 17 17 64 65 65 65 65 65 65 65 66 18
16 17 17 17 17 80 81 81 81 81 81 81 81 82 18
16 17 17 17 17 80 81 81 81 81 81 81 81 82 18
16 17 17 17 17 80 81 81 81 81 81 81 81 82 18
16 17 17 17 17 80 81 81 81 81 81 81 81 82 18
16 17 17 17 17 80 81 81 81 81 81 81 81 82 18
16 17 17 17 17 80 81 81 81 81 81 81 81 82 18
16 17 17 17 17 80 81 81 81 81 81 81 81 82 18
16 17 17 17 17 80 81 81 81 81 81 81 81 82 18
16 17 17 17 17 80 81 81 81 81 81 81 81 82 18
16 17 17 17 17 96 97 97 97 97 97 97 97 98 18
32 33 33 33 33 33 33 33 33 33 33 33 33 33 34
