0  1  1  1  1  1  1  1  1  1  1  1  1  1  2
16 81 81 81 81 81 81 81 81 81 81 81 81 81 18
16 81 81 81 81 81 81 81 81 81 81 81 81 81 18
16 81 81 81 81 81 81 81 81 81 81 81 81 81 18
16 81 81 81 81 81 81 81 81 81 81 81 81 81 18
16 81 81 81 81 81 81 81 81 81 81 81 81 81 18
16 81 81 81 81 81 81 81 81 81 81 81 81 81 18
16 81 81 81 81 81 81 81 81 81 81 81 81 81 18
16 81 81 81 81 81 81 81 81 81 81 81 81 81 18
16 81 81 81 81 81 81 81 81 81 81 81 81 81 18
16 81 81 81 81 81 81 81 81 81 81 81 81 81 18
16 81 81 81 81 81 81 81 81 81 81 81 81 81 18
32 33 33 33 33 33 33 33 33 33 33 33 33 33 34
